{
  "ids": ["empty", "ground.start", "ground", "highlight"],
  "cells": [
    [0, 0, 1, 2, 0, 0, 0, 0, 0, 0],
    [0, 2, 2, 2, 2, 2, 3, 0, 0, 0],
    [0, 2, 2, 2, 2, 2, 2, 0, 0, 0],
    [0, 2, 2, 2, 2, 2, 2, 0, 0, 0],
    [0, 2, 2, 3, 3, 2, 2, 0, 0, 0],
    [0, 2, 2, 2, 3, 2, 2, 0, 0, 0]
  ]
}
