{
  "types": [
    "---",
    "block",
    "slop.left",
    "slop.right",
    "block.half",
    "block.half.highlight",
    "tree",
    "slop.back.right",
    "slop.back.left",
    "block.highlight",
    "---",
    "$player",
    "$poo|5"
  ],
  "cellHeightOffset": -2,
  "cells": [
    [
      [11, 11, 11, 11, 11, 11, 11, 11, 11, 11, 11, 11, 11, 11, 11, 11],
      [11, 11, 11, 11, 11, 11, 11, 11, 11, 11, 11, 11, 11, 11, 11, 11],
      [11, 11, 11, 11, 11, 11, 11, 11, 11, 11, 11, 11, 11, 11, 11, 11],
      [11, 11, 11, 11, 11, 11, 11, 11, 11, 11, 11, 11, 11, 11, 11, 11],
      [11, 11, 11, 11, 11, 11, 11, 11, 11, 11, 11, 11, 11, 11, 11, 11],
      [11, 11, 11, 11, 11, 11, 11, 10, 10, 11, 11, 11, 11, 11, 11, 11],
      [11, 11, 11, 11, 11, 11, 11, 10, 10, 11, 11, 11, 16, 11, 11, 11],
      [11, 11, 11, 11, 11, 16, 11, 11, 11, 11, 11, 11, 11, 11, 11, 11],
      [11, 11, 11, 11, 11, 11, 11, 11, 11, 11, 11, 11, 11, 11, 11, 11],
      [11, 11, 11, 11, 20, 11, 11, 11, 11, 11, 11, 11, 11, 21, 11, 11],
      [11, 11, 11, 11, 11, 11, 11, 11, 11, 11, 11, 11, 11, 11, 11, 11],
      [11, 11, 11, 11, 11, 11, 16, 11, 11, 11, 11, 11, 11, 11, 11, 16],
      [11, 11, 11, 11, 11, 11, 11, 11, 11, 11, 11, 11, 16, 11, 11, 16],
      [11, 11, 11, 11, 11, 11, 11, 11, 11, 11, 11, 11, 11, 11, 11, 11],
      [11, 11, 11, 11, 11, 11, 11, 11, 11, 11, 11, 11, 11, 11, 11, 11],
      [11, 11, 11, 11, 11, 11, 11, 11, 11, 11, 11, 11, 11, 11, 11, 11],
      [11, 11, 11, 11, 11, 11, 11, 11, 11, 11, 11, 11, 11, 11, 11, 11],
      [11, 11, 11, 11, 11, 11, 11, 11, 11, 11, 11, 11, 11, 11, 11, 11]
    ],
    [
      [11, 11, 10, 10, 10, 11, 11, 11, 11, 11, 12],
      [11, 11, 10, 10, 10, 11, 11, 11, 11, 11, 12]
    ],
    [
      [11, 11, 10, 10, 10, 11, 11, 11, 12, 10, 10],
      [11, 11, 10, 10, 10, 11, 11, 11, 12, 10, 10]
    ],
    [
      [11, 11, 10, 10, 10, 11, 11, 10, 10, 10, 10],
      [11, 11, 10, 10, 10, 11, 11, 10, 10, 10, 10]
    ],
    [
      [11, 11, 11, 11, 11, 11, 10, 10, 10, 10, 10],
      [10, 10, 10, 10, 10, 10, 10, 10, 10, 10, 10]
    ]
  ]
}
