{
  "ids": ["empty", "ground.start", "ground", "highlight", "tree"],
  "cells": [
    [0, 0, 1, 2, 0, 0, 0, 0, 0, 0, 2, 2],
    [2, 2, 2, 2, 2, 2, 3, 2, 2, 2, 2, 2],
    [2, 2, 2, 2, 2, 2, 3, 2, 2, 2, 2, 2],
    [2, 2, 2, 2, 2, 2, 3, 2, 2, 2, 2, 2],
    [2, 2, 2, 2, 2, 2, 3, 2, 2, 2, 2, 2],
    [2, 2, 2, 2, 2, 2, 3, 2, 2, 2, 2, 2],
    [2, 2, 2, 2, 2, 2, 3, 2, 2, 2, 2, 2],
    [2, 2, 2, 2, 2, 2, 3, 2, 2, 2, 2, 2],
    [2, 2, 2, 2, 2, 2, 3, 2, 2, 2, 2, 2],
    [2, 2, 2, 2, 2, 2, 3, 2, 2, 2, 2, 2],
    [2, 2, 2, 2, 2, 2, 3, 2, 2, 2, 2, 2],
    [2, 2, 2, 2, 2, 2, 3, 2, 2, 2, 2, 2],
    [2, 2, 2, 2, 2, 2, 3, 2, 2, 2, 2, 2],
    [2, 2, 2, 2, 2, 2, 3, 2, 2, 2, 2, 2],
    [2, 2, 2, 2, 2, 2, 3, 2, 2, 2, 2, 2],
    [2, 2, 2, 2, 2, 2, 3, 2, 2, 2, 2, 2],
    [2, 2, 2, 2, 2, 2, 3, 2, 2, 2, 2, 2],
    [2, 2, 2, 2, 2, 2, 3, 2, 2, 2, 2, 2],
    [2, 2, 2, 2, 2, 2, 3, 2, 2, 2, 2, 2],
    [2, 2, 2, 2, 2, 2, 3, 2, 2, 2, 2, 2],
    [2, 2, 2, 2, 2, 2, 3, 2, 2, 2, 2, 2],
    [2, 2, 2, 2, 2, 2, 3, 2, 2, 2, 2, 2],
    [2, 2, 2, 2, 2, 2, 3, 2, 2, 2, 2, 2],
    [2, 2, 2, 2, 2, 2, 3, 2, 2, 2, 2, 2],
    [2, 2, 2, 2, 2, 2, 3, 2, 2, 2, 2, 2],
    [2, 2, 2, 2, 2, 2, 3, 2, 2, 2, 2, 2],
    [2, 2, 2, 2, 4, 2, 3, 2, 2, 2, 2, 2],
    [2, 2, 2, 2, 2, 2, 3, 2, 2, 2, 2, 2],
    [2, 2, 2, 2, 2, 2, 3, 2, 2, 2, 2, 2],
    [2, 2, 2, 2, 2, 2, 3, 2, 2, 2, 2, 2],
    [2, 2, 2, 2, 2, 2, 3, 2, 2, 2, 2, 2],
    [2, 2, 2, 0, 0, 0, 3, 2, 2, 2, 2, 2],
    [2, 2, 2, 0, 0, 0, 3, 2, 2, 4, 2, 2],
    [2, 2, 2, 0, 0, 0, 3, 2, 2, 2, 2, 2]
  ]
}
